*******************
*....*............*
*...*.............*
*...*............**
*....*..........*.*
*.....*........*..*
*......******.....*
*........******...*
****.....****...***
******.......******
*...********....***
*....******.....***
*.....****......***
*......*****......*
*........*******..*
********........*.*
*.................*
*.................*
*******************


